n m n s n
n m n n i
f m m m n
m n m n n
m i n n m